888888888888888888888888888888
811011111111111111111111111118
833333333333333311111111111118
811111111111111111111111311118
811111111111111111111111311118
811111111111111111111111311118
833333333333333311111111311118
811111111111111111111111311118
811111111111111111111111111118
811111333311111111111111111118
811111111111111111111111111118
811111111111133333333333111118
811111111111131111111111111118
811111111111131111111111111118
811111111111131111111111111118
811111111111131111111111111118
811111111111131111111311111118
811111111111111111111311111118
811111111111111111111311111198
888888888888888888888888888888